{
    "274":  "1474",
    "184":  "1384",
    "121":  "1321",
    "31":  "1231",
    "117":  "1317",
    "59":  "1259",
    "200":  "1400",
    "5":  "1205",
    "53":  "1253",
    "300":  "1500",
    "47":  "1247",
    "100":  "1300",
    "183":  "1383",
    "78":  "1278",
    "210":  "1410",
    "169":  "1369",
    "170":  "1370",
    "89":  "1289",
    "108":  "1308",
    "284":  "1484",
    "233":  "1433",
    "266":  "1466",
    "196":  "1396",
    "235":  "1435",
    "39":  "1239",
    "110":  "1310",
    "51":  "1251",
    "277":  "1477",
    "191":  "1391",
    "224":  "1424",
    "144":  "1344",
    "295":  "1495",
    "13":  "1213",
    "23":  "1223",
    "189":  "1389",
    "72":  "1272",
    "158":  "1358",
    "45":  "1245",
    "14":  "1214",
    "103":  "1303",
    "87":  "1287",
    "49":  "1249",
    "252":  "1452",
    "116":  "1316",
    "81":  "1281",
    "125":  "1325",
    "226":  "1426",
    "281":  "1481",
    "258":  "1458",
    "268":  "1468",
    "113":  "1313",
    "3":  "1203",
    "75":  "1275",
    "153":  "1353",
    "294":  "1494",
    "156":  "1356",
    "94":  "1294",
    "101":  "1301",
    "85":  "1285",
    "146":  "1346",
    "114":  "1314",
    "21":  "1221",
    "251":  "1451",
    "24":  "1224",
    "239":  "1439",
    "265":  "1465",
    "52":  "1252",
    "163":  "1363",
    "213":  "1413",
    "43":  "1243",
    "145":  "1345",
    "209":  "1409",
    "154":  "1354",
    "289":  "1489",
    "173":  "1373",
    "168":  "1368",
    "237":  "1437",
    "32":  "1232",
    "20":  "1220",
    "287":  "1487",
    "73":  "1273",
    "253":  "1453",
    "221":  "1421",
    "133":  "1333",
    "8":  "1208",
    "29":  "1229",
    "225":  "1425",
    "241":  "1441",
    "2":  "1202",
    "62":  "1262",
    "297":  "1497",
    "33":  "1233",
    "175":  "1375",
    "205":  "1405",
    "193":  "1393",
    "84":  "1284",
    "107":  "1307",
    "240":  "1440",
    "58":  "1258",
    "257":  "1457",
    "139":  "1339",
    "192":  "1392",
    "112":  "1312",
    "48":  "1248",
    "195":  "1395",
    "177":  "1377",
    "260":  "1460",
    "190":  "1390",
    "229":  "1429",
    "42":  "1242",
    "130":  "1330",
    "65":  "1265",
    "215":  "1415",
    "157":  "1357",
    "35":  "1235",
    "172":  "1372",
    "60":  "1260",
    "290":  "1490",
    "279":  "1479",
    "152":  "1352",
    "115":  "1315",
    "34":  "1234",
    "132":  "1332",
    "104":  "1304",
    "162":  "1362",
    "238":  "1438",
    "214":  "1414",
    "28":  "1228",
    "197":  "1397",
    "76":  "1276",
    "166":  "1366",
    "167":  "1367",
    "155":  "1355",
    "230":  "1430",
    "50":  "1250",
    "188":  "1388",
    "299":  "1499",
    "106":  "1306",
    "80":  "1280",
    "19":  "1219",
    "264":  "1464",
    "244":  "1444",
    "10":  "1210",
    "243":  "1443",
    "9":  "1209",
    "134":  "1334",
    "261":  "1461",
    "57":  "1257",
    "249":  "1449",
    "292":  "1492",
    "219":  "1419",
    "142":  "1342",
    "201":  "1401",
    "64":  "1264",
    "223":  "1423",
    "285":  "1485",
    "165":  "1365",
    "12":  "1212",
    "119":  "1319",
    "99":  "1299",
    "273":  "1473",
    "129":  "1329",
    "127":  "1327",
    "278":  "1478",
    "93":  "1293",
    "228":  "1428",
    "199":  "1399",
    "1":  "1201",
    "204":  "1404",
    "122":  "1322",
    "66":  "1266",
    "296":  "1496",
    "82":  "1282",
    "211":  "1411",
    "126":  "1326",
    "185":  "1385",
    "41":  "1241",
    "217":  "1417",
    "271":  "1471",
    "179":  "1379",
    "37":  "1237",
    "111":  "1311",
    "123":  "1323",
    "91":  "1291",
    "242":  "1442",
    "181":  "1381",
    "291":  "1491",
    "250":  "1450",
    "178":  "1378",
    "79":  "1279",
    "194":  "1394",
    "68":  "1268",
    "216":  "1416",
    "143":  "1343",
    "171":  "1371",
    "255":  "1455",
    "270":  "1470",
    "267":  "1467",
    "182":  "1382",
    "92":  "1292",
    "118":  "1318",
    "254":  "1454",
    "18":  "1218",
    "90":  "1290",
    "256":  "1456",
    "161":  "1361",
    "135":  "1335",
    "293":  "1493",
    "56":  "1256",
    "150":  "1350",
    "83":  "1283",
    "141":  "1341",
    "275":  "1475",
    "71":  "1271",
    "282":  "1482",
    "286":  "1486",
    "164":  "1364",
    "11":  "1211",
    "105":  "1305",
    "16":  "1216",
    "272":  "1472",
    "77":  "1277",
    "283":  "1483",
    "263":  "1463",
    "187":  "1387",
    "25":  "1225",
    "137":  "1337",
    "54":  "1254",
    "208":  "1408",
    "207":  "1407",
    "6":  "1206",
    "67":  "1267",
    "40":  "1240",
    "288":  "1488",
    "149":  "1349",
    "27":  "1227",
    "30":  "1230",
    "96":  "1296",
    "232":  "1432",
    "227":  "1427",
    "248":  "1448",
    "128":  "1328",
    "97":  "1297",
    "280":  "1480",
    "246":  "1446",
    "218":  "1418",
    "222":  "1422",
    "180":  "1380",
    "4":  "1204",
    "46":  "1246",
    "120":  "1320",
    "74":  "1274",
    "212":  "1412",
    "147":  "1347",
    "98":  "1298",
    "70":  "1270",
    "247":  "1447",
    "174":  "1374",
    "17":  "1217",
    "69":  "1269",
    "88":  "1288",
    "262":  "1462",
    "102":  "1302",
    "269":  "1469",
    "136":  "1336",
    "55":  "1255",
    "131":  "1331",
    "22":  "1222",
    "44":  "1244",
    "236":  "1436",
    "202":  "1402",
    "109":  "1309",
    "151":  "1351",
    "231":  "1431",
    "61":  "1261",
    "198":  "1398",
    "234":  "1434",
    "176":  "1376",
    "15":  "1215",
    "140":  "1340",
    "86":  "1286",
    "276":  "1476",
    "186":  "1386",
    "203":  "1403",
    "26":  "1226",
    "138":  "1338",
    "36":  "1236",
    "38":  "1238",
    "245":  "1445",
    "298":  "1498",
    "206":  "1406",
    "160":  "1360",
    "7":  "1207",
    "259":  "1459",
    "63":  "1263",
    "124":  "1324",
    "148":  "1348",
    "220":  "1420",
    "159":  "1359",
    "95":  "1295"
}
